E    X    E   X     E
     X        X      
     XXXXXXXXXX      
     X   EE   X      
LLLLLX BBBBBB XLLLLLL
LLLLLX BLLLLB XLLLLLL
XXXXXX BLLLLB XXXXXXX
BBBBBX BLLLLB XBBBBBB
BBBBBX BBBBBB XBBBBBB
     X        X      
     XXXXXXXXXX      
                     
        S        E   
      P              
