E    X    E   X     E
LLLXXXX       X X    
LLLXXXX      BBBBBXXX
   XXXX UUU  BBBBLLLL
   XWWW  U       LLLL
UUUX W      LLLL     
UUUX  BBB   LLLLXXXXX
BBBX  BBB   LLLL WU B
BBBLLLLLLLLLLLLL W  B
  W     XXBBBBB  W  B
  W     XXBBBBBXXXX B
XXXUU          XXUU B
UU      S           B
      P             B
