E    X    E   X     E
   XXXX       X X    
   XXXX      BBBBBXXX
   XXXX UUU      LLLL
   X     U       LLLL
UUUX        LLLL     
UUUX  BBB   LLLLXXXXX
BBBX  BBB   LLLL  U B
BBBLLLLLLLLLLLLL    B
        XXBBBBB     B
        XXBBBBBXXXX B
XXXUU          XXUU B
UU      S           B
      P             B