E    XXXL E   X     E
BBBBBB       XXXXXXBL
XXXXBB       LLLLLLBL
XXXXBBBBBX   LBBLLLBL
LWBXUUBBXXX WLLLLLLBL
LWBX ULB XXBBLLXXXXBX
LLLL XXL XXBBLLXXWXBX
LLBW XXL XXBBLLXXUXBU
WWWWXX UU   WLLXXUXBX
BBBBBB LLXX WWLLWWWBX
XBBBBX LLXX W  LWWWBX
XXXBB          LLLLBX
XXBB    S       UE  X
XXXX  P          XXXX
