E    XL   E   XBB  BE
LBBXXXLLLLU   XBB  BX
LBBXXXXXXXXXXXXBBX BX
U    LLLLLLLLLLLBBBBX
U  BBBBBWWWWBBULXXXBX
XXBBBBBWWWWWWBBL  XBX
XX  BBWWWWWWWWBL XXBX
XXX  BBWWWWWWBBLBBBBX
   XL BBWWWWBLLLBBBBL
XXXXL BBBULLLLXXXXXLL
LLLLLXXXBBBBXXX   XLL
LXX        BBB WW  LL
UUXX    S    B WW LLL
      P      B   LLLL
