E    XX   E   X     E
BBBXXXXXXLLLXXXXXXXXX
BBBXXXXXXLLLXXXXXXWWW
LLLLLLLLLLLLLLLLLLLXX
WWWWWWXXLXXXXXXXXXLXX
BBBBBBBBLLLLLEXXXXLXX
WWWWWWWWWWXXLXXXXXLWW
BBBBBBBBBBLLLLLLLLLWW
XXUUX  EXXXLLXEXBBBXX
XXUUX   XXXLLXXXBBBXX
XXXXX   XXXLLXXXXXXXX
XXX            UUBLLL
XX      S       WBLLL
X     P       WWWBLLL
